-17
17
-10
10
00000000000000000000000000000000000
00000000000000000000000000000000000
00000000000000000000000000000000000
00000000000000000000000000000000000
00000000000000000000000000000000000
00000000000000000000000000000000000
00000000000000000000000000000000000
00000000000000000000000001100000000
00000000000000000000111111100000000
00000000000000000000111111100000000
00000001000000000000111111100000000
00000000000001000000111111100000000
00000000000000000000111111100000000
00000000001000000000111111100000000
00000000000000000000111111100000000
10000000000000000000000000000000000
10000000000000000000000000000000000
10000000000000000000000000000000000
10000000000000000000000000000000000
10000001111111111111111111111111110
11111111000000000000000000000000000
